111111111111111111
110000001111111111
100000P0000000P111
11110000000E000001
111111111CCC000001
111111111111111111