1111111111111111111111111111111111111111
1111111111111111111111111111111111111111
100P001111100000000010000010C00001000001
10000010C000000000001000001000000100C001
1100000100001111111110000001000111000001
11110001000011111110000000111C0000000001
1C0000000000111C000000000100000011111111
1000000011110000000001100000000001111111
1100000C11110000011001100000000001110001
10C00000011100100000011000000000C0000001
1000000000110000000001C0000010000001C001
1000000000001000C00110000001000000100001
100C001111111100000110000010000001000001
110000001111000000011000010000C010000001
111100000110000011111000100000010000C001
111111000000C000111110010000001000000001
1111111110000000000000100000010000000011
11E00000000C0000000001000000100000000C01
1111111111111111111111111111111111111111
1111111111111111111111111111111111111111