1111111111111
1111111111111
110C11P0E0011
1100010000011
110C000C01111
1111111111111
1111111111111