1111111111111111
1011000C00110001
10P1001100010001
1000011100C10E01
110C011100010001
1100000011000010
1111111111111111