111111111111111111111111
111111111111111111111111
1111100000P11111000C1111
11000C11111000E000000011
111100001110000000000011
111111111111111111111111
111111111111111111111111