11111111111
100001110111
10111011111
1P000C00CE11
11111111111